offspring=The offspring contain a mixture of the genetic blueprint of each parent.=后代体内含有父母亲基因图谱的混合。
scare=He doesn't scare easily.=他不轻易害怕。
capsule=You are asked to swallow a capsule containing vitamin B.=你被要求吞下一颗含维生素B的胶囊。
adhere=One must be duly self-disciplined to adhere to it.=人要适当自律才能坚持它。
revive=The paramedics couldn't revive her.=护理人员无法使她苏醒。
enrich=Literature can enrich your spiritual life.=文学可以丰富你的精神生活。
abnormal=They thought his behaviour was abnormal.=他们认为他行为反常。
shiver=A violent shiver convulsed him.=剧烈的颤抖使他抽搐不已。
differentiate=I can't differentiate one variety from another.=我无法将这几个品种区别开来。
monopoly=Had he succeeded, he would have acquired a monopoly.=如果他那时成功了，他就会获得垄断地位。
lessen=Toolbelts free both hands and lessen the risk of dropping hammers.=工具带解放了双手，并减少了锤子掉落的危险。
alternate=Dark stripes alternate with pale ones.=深浅条纹相间。
vent=She gave vent to her anger and jealousy.=她发泄了自己的怒意和嫉妒。
identical=The two pictures are similar, although not identical.=这两幅画很相似，虽然不完全相同。
qualification=The plan was approved without qualification.=这项计划获得无条件批准。
radioactive=Radioactive water had seeped into underground reservoirs.=放射性水已渗入了地下蓄水池。
plausible=She was a plausible liar.=她是个巧言令色的说谎高手。
bounce=There's not much bounce left in these balls.=这些球已没有多少弹性了。
resort=The resort is geared towards children.=这个旅游胜地适合儿童玩耍。
perspective=In his art he broke the laws of scientific linear perspective.=他在自己的绘画艺术中打破了科学的直线透视法规律。
encounter=Did you encounter anyone in the building?=你在那栋大楼里偶然遇到什么人了吗？
litter=Animals reject the runt of the litter.=动物们排斥一窝中最弱小的幼仔。
accelerate=Inflation continues to accelerate.=通货膨胀不断加速。
dilute=There was a clear intention to dilute black voting power.=削弱黑人选举权的意图是显而易见的。
terror=Her eyes were wild with terror.=她的眼睛里充满了恐惧。
adjacent=The planes landed on adjacent runways.=这些飞机在毗连的跑道上降落。
reinforce=I hope this will reinforce Indonesian determination to deal with this kind of threat.=我希望这会加强印度尼西亚对付这类威胁的决心。
transfer=The novel does not transfer well to the movies.=这部小说不太适宜改编成电影。
anxiety=Her voice was full of anxiety.=她的声音饱含焦虑。
advantage=His height gives him a clear advantage.=他的身高使他具有明显的优势。
consumption=Energy consumption rises as countries industrialize.=能源消耗随着各国工业化而增加。
heighten=I think what screen dance will do, though, is heighten awareness of dance in general.=我认为荧屏舞蹈会在总体上提高人们对舞蹈的认知。
precise=She gave me clear and precise directions.=她给了我清晰而准确的指示。
calculate=This formula is used to calculate the area of a circle.=这个公式用于计算圆的面积。
thesis=This thesis does not stand up to close inspection.=这个论点经不起仔细推敲。
insulate=Huxley speculated that a coat of hair would insulate against loss of body heat and might streamline the body to reduce drag in flight.=赫胥黎推测，一层毛发可以隔离身体热量的流失，并可能使身体呈现流线型，以减少飞行中的阻力。
mature=Jane is very mature for her age.=简年龄不大，却很成熟。
drawback=The main drawback to it is the cost.=它的主要缺点是成本高。
occasional=I enjoy the occasional glass of wine.=我喜欢偶尔喝一杯葡萄酒。
virtual=The company has a virtual monopoly in this area of trade.=这家公司实质上已经垄断了这种贸易。
doom=Does this spell the doom of the physical book?=这是否意味着实体书的末日？
bankrupt=They went bankrupt in 1993.=他们于1993年破产。
adapt=It's amazing how soon you adapt.=你这么快就适应了，真是令人惊奇。
choke=Very small toys can choke a baby.=很小的玩具可使婴儿窒息。
integral=As an integral part of learning, it brings about positive changes, making people develop and grow.=作为学习的一个组成部分，它带来了积极的变化，使人发展和成长。
innovation=His greatest innovation was the use of interchangeable parts.=他最伟大的创新是使用了可互换部件。
uphold=We have a duty to uphold the law.=维护法律是我们的责任。
outbreak=The area was struck by an outbreak of cholera.=那一地区爆发了霍乱。
transit=The contents of the package may have settled in transit.=包裹里的东西可能在运输途中摇密实了。
combination=His treatment was a combination of surgery, radiation and drugs.=对他的治疗是把手术、放射和药物治疗结合为一体。
subsidy=European farmers are planning a massive demonstration against farm subsidy cuts.=欧洲的农场主们正在策划一场反对削减农场补贴的大游行。
compromise=I refuse to compromise my principles.=我拒绝在原则问题上妥协。
occupation=Parachuting is a dangerous occupation.=跳伞是一种危险的消遣。
occupy=How much memory does the program occupy?=这个程序占用多少内存？
eliminate=This diet claims to eliminate toxins from the body.=这种饮食据称具有排除体内毒素的作用。
rupture=I nearly gave myself a rupture lifting that pile of books.=提那一大堆书差点儿让我得了疝气。
skeptical=If you're still skeptical about exercising, we can only ask you to trust us and give it a try.=如果你仍对锻炼持怀疑态度，我们只能请你相信我们，试一试。
lean=He was tall, lean and handsome.=他长得瘦高而英俊。
casual=The boy was cheeky and casual.=这个男孩嘻皮笑脸、随随便便。
approach=There's a certain novelty value in this approach.=这种方法有一定的新意。
memorial=The town raised a memorial to those killed in the war.=这座小镇为战争中牺牲的人树立了一座纪念碑。
challenge=Bill was stimulated by the challenge.=比尔受到该挑战的激励。
economical=Fans of electric cars say they are clean, quiet, and economical.=电动车爱好者说电动车无污染，无噪音，而且经济。
afflict=There are two main problems which afflict people with hearing impairments.=有两大问题困扰有听觉障碍的人。
haunt=That decision came back to haunt him.=那个决定对他造成无法摆脱的困扰。
drain=The main drain was blocked.=主下水道被堵住了。
ignorant=He's ignorant about modern technology.=他对现代科技一无所知。
designate=Japan's prime minister-designate is completing his cabinet today.=日本即将上任的首相今天将完成他的内阁组建。
murmur=The doctor said James had now developed a heart murmur.=医生说詹姆斯心脏现在出现了杂音。
exert=A number of neurotransmitters exert their effects by first increasing cyclic AMP concentrations in target neurons.=许多神经递质首先通过增加靶神经元中的循环 AMP 浓度来发挥其作用。
fancy=So you fancy yourself as the boss someday?=那么你认为自己有一天会成老板？
violate=Thornburgh said such demands wouldn't violate the First Amendment.=桑伯说这样的要求不违反第一修正案。
idle=Now the machine is lying idle.=现在这台机器正处于闲置状态。
donate=They should donate at the registration point.=他们应该在注册登记处捐款。
mall=The local kids hang out at the mall.=当地的孩子常在商场闲荡。
overcome=They had to overcome formidable obstacles.=他们得克服重重障碍。
slash=The mayor will have to slash the city's already bare-bones budget.=市长将不得不削减该市已经降到最低限度的预算。
forerunner=As the forerunner, "United 93" will take most of the heat, whether it deserves it or not.=作为先驱，无论是否值得，“93号曼联”都将承受大部分的压力。
stable=Mentally, she is not very stable.=她的心理状态不十分稳定。
remedy=There is no simple remedy for unemployment.=失业问题没有简单的解决办法。
foresee=He did not foresee any problems.=他没有预见到任何问题。
toxic=Many pesticides are highly toxic.=许多杀虫剂毒性很大。
furnish=They'll be able to furnish you with the rest of the details.=他们将能够给你提供其余的细节。
esteem=You need to build your self-esteem.=你需要树立自尊心。
expose=Altman strips away the pretense and mythology to expose the film industry as a business like any other.=奥尔特曼揭穿伪装和神话，把电影业暴露成像其他任何行业一样。
cheerful=Why are you so bright and cheerful today?=你今天怎么这么高兴？
furthermore=Furthermore, they claim that any such interference is completely ineffective.=此外，他们声称任何此类干涉都是完全无效的。
vigorous=She was a very vigorous sort of person.=她是那种精力非常旺盛的人。
conserve=People should insulate their homes to conserve energy.=人们应该使住房隔冷以保存能量。
explicit=He gave me very explicit directions on how to get there.=他清楚地向我说明了去那儿的路线。
betray=He was offered money to betray his colleagues.=有人收买他出卖他的同事。
